111111111
100E0P0C1111
111111111111