1111111111111111111111111111111111
100000000000000C000000000000000011
1111010100100000101001000000010101
1010010010101010001001000000011111
100000000000000000P0000000000E0001
1111111111111111111111111111111111